%%%%%%%%%%%%%%%%%%%%%%%%%%%%
%............%%............%
%.%%%%.%%%%%.%%.%%%%%.%%%%.%
%o%%%%.%%%%%.%%.%%%%%.%%%%o%
%.%%%%.%%%%%.%%.%%%%%.%%%%.%
%..........................%
%.%%%%.%%.%%%%%%%%.%%.%%%%.%
%.%%%%.%%.%%%%%%%%.%%.%%%%.%
%......%%....%%....%%......%
%%%%%%.%%%%% %% %%%%%.%%%%%%
%%%%%%.%%%%% %% %%%%%.%%%%%%
%%%%%%.%%          %%.%%%%%%
%%%%%%.%% %%%  %%% %%.%%%%%%
%     .   %G GG G%   .     %
%%%%%%.%% %%%%%%%% %%.%%%%%%
%%%%%%.%%           %.%%%%%%
%%%%%%.%% %%%%%%%%% %.%%%%%%
%............%%............%
%.%%%%.%%%%%.%%.%%%%%.%%%%.%
%.%%%%.%%%%%.%%.%%%%%.%%%%.%
%o..%%....... P.......%%..o%
%%%.%%.%%.%%%%%%%%.%%.%%.%%%
%%%.%%.%%.%%%%%%%%.%%.%%.%%%
%......%%....%%....%%......%
%.%%%%%%%%%%.%%.%%%%%%%%%%.%
%..........................%
%%%%%%%%%%%%%%%%%%%%%%%%%%%%
