%%%%%
% . %
%.G.%
% . %
%. .%
%P .%
%%%%%
