%%%%%%%%%%%%%%%%%%%%%%%%%%%%
%..........................%
%.%%%%%%%.%%%%%%%%.%%%%%%%.%
%o%%%%%%%.%%%%%%%%.%%%%%%%o%
%......%%.%%....%%.%%......%
%.%%%%.%%.%%.%%.%%.%%.%%%%.%
%.%__%.%%.%%.%%.%%.%%.%__%.%
%.%%%%.%%.%%.%%.%%.%%.%%%%.%
%............%%............%
%.%%%%%%% %%%%%%%% %%%%%%%.%
%.%%%%%%% %%%%%%%% %%%%%%%.%
%...%%.            B .%%...%
%%%.%%.%% %%%  %%% %%.%%.%%%
%%%.%%.%% %      % %%.%%.%%%
%  ....%% %      % %%....  %
%%%.%%%%% %      % %%%%%.%%%
%_%.%%%%% %%%%%%%% %%%%%.%_%
%_%....%%          %%....%_%
%_%.%%.%% %% %% %% %%.%%.%_%
%%%.%%.%% %% %% %% %%.%%.%%%
%...%%....%% %% %%....%%...%
%.%%%%.%%%%% %% %%%%%.%%%%.%
%.%%%%.%%%%% %% %%%%%.%%%%.%
%............ P............%
%o%%.%%%%.%%%%%%%%.%%%%.%%o%
%.%%.%%%%.%%%%%%%%.%%%%.%%.%
%.%%...%%.%%....%%.%%...%%.%
%.%%%%.%%.%%.%%.%%.%%.%%%%.%
%.%%%%.%%.%%.%%.%%.%%.%%%%.%
%............%%............%
%%%%%%%%%%%%%%%%%%%%%%%%%%%%
